80 20
W WHW WHW WHW WHWWWWWWWWWWWWWWWWWWWWWWWWW WHW WHWWWHW WHWWWWWWWWWWWWWWWWWWWWWWWW
W            HHH HHHH WW            HHHW         W          W         W     HHHW
W            W                      HHHW         W          WW              HHHW
W            W               WWWWWWWWWWW                    W                  W
WWWWWWWWW    WWWWWWWWWWWWWWWWW                              W         W        W
W                           W                               W         W        W
W                           W                                         W        W
W        W                  W          HHH       W             WWWWWWWWWWWWWWWWW
W        W                  W         HHH        W                             W
WWWWWWWWWWW                          HHH         WWWWWWW                       W
W                           H                    W            W                W
W                    HHHHHHHH                    W            W                W 
W                    HHHHHHHH                    W            W                W
W                           H           WWWWWWWWWWWWWWWWWWWWWWWWWWWWWWWWWWWWWWWW 
W                                                         W           W        W 
W             W          WWWWWWWWWWW                                  WWWW  WWWW
W    HHHH     W          W         W            W         W           W        W
W    HHHH     W          W         W            W         W                    W
W             W                    W            W         W                    W
WWWWWWWWWWWWWWWWWWWWWWWWWWWWWWWWWWWWWWWWWWWWWWWWWWWWWWWWWWWWWWWWWWWWWWWWWWWWWWWW