40 5
W WHW WHW WHW WHWWWWWWWWWWWWWWWWWWWWWWWW
W            HHH HHHH WW            HHHW
W            W                      HHHW
W      WWWWWWW               WWWWWWWWWWW
WWWWWWWWWWWWWWWWWWWWWWWWWWWWWWWWWWWWWWWW